wwwwwwwww
wp  !!  w
w       w
w     ! w
w       w
w !    *w
wwwwwwwww