wwwwwwwwwww
wp    !   w
w         w
w !     ! w
w         w
w   !!  * w
wwwwwwwwwww